17 17 17 17 16 16 16 16 17 17 16 16 17 16 16 16 17 16 17 17 16 17 16 17 16 17 16 17 17 17 16 17 16 17 17 16 17 17 17 16 17 17 17 17 17 17 17 17 17 17 
17 17 16 16 17 17 16 16 17 17 17 16 16 16 16 16 17 17 16 16 17 16 16 17 16 17 17 17 16 17 16 17 17 16 17 16 16 17 16 16 16 17 16 16 17 17 16 16 17 17 
16 16 17 17 17 16 16 17 16 17 16 16 16 17 16 17 17 17 17 17 16 17 17 17 16 16 16 17 17 17 16 17 16 16 17 17 17 16 16 16 17 16 17 17 17 16 17 16 16 17 
17 17 17 16 16 16 17 16 16 16 16 16 17 16 17 16 16 17 17 16 16 17 16 17 16 17 17 16 17 17 17 16 17 16 16 16 17 17 17 16 16 16 16 17 17 17 16 16 17 16 
17 17 16 17 17 17 16 16 17 17 16 16 17 16 16 17 17 16 17 17 17 17 17 16 16 17 17 17 16 16 17 16 16 16 17 17 16 16 17 16 16 16 16 16 16 16 16 16 16 16 
17 16 17 17 17 16 16 17 17 17 16 17 17 16 16 16 16 17 17 17 17 17 16 16 16 16 16 17 16 16 17 17 16 16 16 17 17 17 17 16 17 17 17 17 16 17 17 17 16 16 
17 17 16 16 17 17 16 17 17 17 16 17 17 17 17 17 17 17 16 17 17 16 17 16 16 16 16 17 16 16 17 16 16 16 16 17 17 16 16 17 17 16 17 16 16 17 17 17 16 16 
17 16 17 17 17 16 17 16 17 17 16 17 16 16 16 17 17 17 17 17 16 16 16 16 17 16 17 16 17 16 16 17 16 16 17 16 17 17 16 16 17 17 16 16 17 17 16 17 16 17 
16 16 16 17 16 16 17 17 26 24 24 24 24 24 24 24 24 24 24 24 24 24 24 24 24 24 24 24 24 24 24 24 24 24 24 24 24 24 24 24 24 27 17 16 16 17 17 16 17 16 
16 16 16 16 16 17 16 16 22 13 12 13 12 13 13 12 13 13 12 12 12 12 13 12 12 12 12 13 12 12 12 13 13 13 13 12 13 12 13 12 13 21 17 16 16 17 16 16 16 16 
16 16 16 16 17 16 17 17 22 12 12 12 12 12 13 12 12 12 13 13 13 12 12 13 12 13 12 12 13 12 12 12 12 12 13 13 13 13 13 12 13 21 16 16 17 16 16 17 17 16 
16 17 17 17 16 17 16 17 22 13 13 12 13 12 13 13 13 12 13 13 13 13 12 12 12 12 13 12 12 12 13 13 12 13 12 12 13 12 12 13 13 21 17 16 17 17 17 16 16 17 
16 17 16 17 17 17 16 16 22 13 12 13 12 12 13 12 13 13 13 13 12 12 13 13 13 13 12 12 12 13 12 12 12 13 13 13 12 13 13 13 12 21 17 16 17 17 16 16 17 16 
17 16 16 16 17 16 17 17 22 12 12 12 13 12 12 12 13 12 12 12 12 13 13 12 13 12 12 13 13 12 13 13 13 13 12 13 13 13 12 13 13 21 16 17 16 17 16 17 17 17 
17 16 17 17 16 16 17 16 22 13 13 12 12 12 13 12 12 12 12 12 12 12 13 13 12 13 13 12 13 12 13 12 12 12 13 12 12 12 12 12 12 21 16 17 17 17 16 17 16 17 
16 16 17 17 17 16 16 16 22 13 12 13 12 12 12 12 13 12 12 13 12 13 12 13 12 13 13 12 12 12 13 12 13 13 13 12 13 13 13 13 13 21 17 16 16 16 16 17 16 16 
17 17 16 16 17 17 16 17 22 13 13 12 12 12 12 12 12 13 13 12 12 12 13 12 13 13 12 12 13 13 12 13 12 12 12 13 12 12 12 12 13 21 17 16 16 16 17 16 16 16 
17 16 16 16 17 17 16 16 22 12 13 13 13 13 12 13 13 13 12 12 12 13 13 12 12 12 13 12 12 13 13 13 13 13 12 12 13 12 13 13 13 21 16 16 16 16 17 17 17 17 
17 17 16 17 16 17 17 17 22 12 12 13 13 13 12 13 12 12 12 12 13 12 12 12 12 13 13 12 13 12 13 12 12 13 12 12 13 12 13 12 12 21 16 16 17 16 16 16 16 17 
17 17 16 16 17 16 16 16 22 12 12 12 12 13 13 12 13 13 13 12 13 13 12 13 12 13 13 13 12 12 13 13 12 12 12 13 13 13 12 12 12 21 16 17 16 16 16 17 16 16 
17 17 17 16 16 17 16 16 22 13 12 12 13 13 12 13 12 12 13 12 13 12 12 13 13 12 13 13 12 12 13 12 13 12 12 12 13 13 13 13 12 21 17 17 17 16 17 17 17 16 
16 17 16 17 17 16 16 16 22 12 12 12 12 12 13 13 12 13 13 13 12 12 12 13 12 12 12 13 13 12 13 13 13 13 13 12 13 13 12 12 12 21 17 17 17 17 16 16 17 16 
17 17 17 17 16 17 16 17 22 12 13 12 13 13 13 13 13 13 13 12 13 12 13 13 13 12 13 12 12 12 12 12 13 12 12 12 12 12 13 12 12 21 17 17 17 16 16 17 16 17 
17 16 17 16 16 16 17 17 22 12 13 13 12 13 12 13 13 12 13 13 12 13 13 12 12 12 12 12 13 13 13 13 12 13 12 13 12 12 12 12 12 21 16 17 16 16 16 17 16 17 
17 17 16 16 16 17 16 17 22 13 12 13 13 13 13 13 13 13 12 12 13 12 13 12 12 13 12 13 12 12 12 12 13 12 13 13 13 13 13 13 13 21 17 17 16 16 16 17 17 16 
17 17 16 16 16 16 17 17 22 13 13 12 12 12 12 12 13 12 12 13 13 13 13 12 12 13 12 13 13 13 12 12 13 13 12 12 13 12 13 13 13 21 16 16 17 16 17 16 16 17 
17 17 16 16 17 16 17 16 22 13 12 12 12 12 13 12 13 13 12 12 13 12 13 13 12 12 12 13 13 12 12 13 12 13 13 12 13 13 13 12 12 21 17 17 16 16 17 17 16 17 
17 16 17 17 16 16 17 16 22 13 13 13 12 13 12 13 12 13 12 12 13 13 12 13 13 12 13 13 12 13 12 12 13 13 12 12 13 13 12 12 13 21 16 16 16 17 16 16 17 17 
17 16 17 16 16 16 16 17 22 13 13 12 12 13 12 13 13 12 12 13 12 13 12 13 12 13 13 13 13 12 12 13 12 12 13 12 13 13 13 12 12 21 16 17 16 16 16 16 17 17 
17 16 17 16 17 16 17 17 22 13 12 12 13 13 12 13 12 12 13 13 12 13 13 13 13 12 12 12 12 13 12 13 13 12 13 13 13 12 12 13 12 21 17 17 16 16 17 16 16 16 
17 16 17 17 17 17 16 17 22 13 13 12 12 13 13 13 12 13 13 12 12 13 12 12 12 13 12 12 13 12 13 13 13 12 12 13 12 12 12 12 12 21 17 16 16 17 17 16 17 17 
17 16 16 17 17 17 17 17 22 13 13 12 13 13 13 13 13 12 12 12 13 13 13 12 12 12 13 13 13 13 12 13 12 13 12 13 13 12 12 13 13 21 17 16 16 17 16 17 16 16 
16 17 17 17 16 17 17 17 22 12 13 12 12 13 13 12 12 13 12 13 13 12 13 12 12 12 13 12 12 12 12 13 13 13 13 12 12 12 13 13 12 21 17 17 17 16 17 17 17 17 
17 17 16 17 16 16 17 16 22 12 12 12 13 12 13 12 13 13 13 13 13 12 13 12 13 13 13 13 12 13 12 13 13 12 12 12 13 13 12 13 13 21 16 16 17 17 17 16 16 16 
16 17 17 16 17 16 16 16 22 13 13 13 13 12 12 13 13 13 13 13 12 12 13 12 13 12 12 13 12 13 13 12 12 13 12 12 12 12 13 13 13 21 17 17 17 17 17 16 17 16 
16 17 17 16 16 16 16 16 22 13 12 12 12 12 13 12 13 12 12 13 13 12 13 13 12 12 12 12 13 12 13 12 13 13 13 13 13 12 12 12 13 21 17 16 16 17 17 17 17 17 
17 17 16 16 16 16 16 17 22 13 13 13 12 12 12 13 13 12 12 12 12 13 12 13 13 13 12 13 13 12 12 12 12 12 12 13 12 12 13 13 13 21 17 17 16 16 16 17 16 17 
17 17 16 17 17 17 17 17 22 12 13 12 12 12 13 12 12 12 12 13 12 12 12 12 13 13 12 12 13 12 12 12 13 13 13 12 13 12 13 13 13 21 16 16 16 17 16 16 16 17 
16 17 16 16 17 16 16 16 22 12 13 12 13 13 13 13 12 12 13 12 13 13 13 13 13 13 13 12 12 12 12 13 13 13 13 12 12 12 13 12 12 21 17 16 17 17 16 17 16 17 
17 17 17 17 16 16 16 17 22 12 13 13 12 13 13 12 12 13 12 13 12 12 13 13 12 12 12 12 13 12 13 13 12 13 12 12 12 13 12 13 12 21 16 16 16 16 17 16 16 17 
17 16 16 17 17 17 17 16 22 13 13 13 13 12 12 13 12 13 12 12 12 12 13 13 13 12 12 12 13 13 12 13 12 12 12 12 12 12 12 12 12 21 16 17 16 16 16 17 16 16 
17 17 16 17 17 16 17 16 28 19 19 19 19 19 19 19 19 19 19 19 19 19 19 19 19 19 19 19 19 19 19 19 19 19 19 19 19 19 19 19 19 29 17 16 16 16 17 17 17 17 
16 17 16 16 16 17 17 17 17 16 16 17 17 17 17 17 17 16 17 17 17 16 17 17 17 17 16 17 17 17 16 16 17 16 17 16 16 16 17 17 17 16 16 17 16 16 17 17 16 16 
17 17 16 16 17 16 16 17 16 17 17 16 17 17 16 17 16 17 17 17 16 16 16 17 16 16 17 17 17 17 16 17 16 17 17 16 17 17 16 17 16 17 17 17 16 16 17 16 17 17 
17 16 17 16 17 17 16 17 17 17 16 16 16 17 16 16 17 17 17 16 16 17 17 17 16 17 17 16 16 17 16 16 17 17 16 16 16 16 16 16 16 16 17 16 16 16 17 17 16 17 
16 16 17 16 16 17 17 17 17 17 16 16 16 17 16 16 17 17 17 17 16 16 16 17 16 17 17 17 16 16 17 17 16 17 17 17 17 16 16 16 16 17 17 17 16 16 16 16 17 17 
16 16 17 16 17 16 17 17 16 17 16 17 17 17 16 16 16 16 17 17 17 16 16 17 16 16 17 17 16 17 17 17 17 16 17 17 16 16 17 17 17 17 16 17 17 17 17 17 17 17 
16 17 16 17 17 16 16 17 17 17 17 16 17 16 16 16 17 17 17 16 16 17 16 17 17 17 16 16 17 16 16 16 16 16 16 16 16 17 17 16 16 17 16 16 16 17 16 17 17 17 
16 17 17 17 16 17 17 17 17 17 17 17 17 17 16 17 17 16 17 16 16 16 17 16 16 17 16 16 16 17 17 17 16 16 16 17 17 16 16 17 17 17 16 16 16 17 17 16 16 16 
16 16 16 16 17 16 17 17 17 17 17 16 17 16 17 17 16 16 17 16 17 16 17 17 17 16 16 16 17 17 17 16 17 17 17 16 16 17 16 17 17 17 16 16 16 16 17 17 16 17 
